NO Resources/texture/no.xpm
SO Resources/texture/so.xpm
WE Resources/texture/we.xpm
EA Resources/texture/ea.xpm
C 52,152,219
F 88,64,64
                    
        1111111111111111111111111
        1000000000110000000000001
        1011000001110000001000001
        10010000000000000W0100001
111111111011000001110000000000001
100000000011000001110111111101111
11110111111111011100000000001
11110111111111011101010010001
11000001110101011100000010001
100000000000000011000000100001
10000000000000001101010010001
1100000111010101 11101111000111
1111011  1110101 101111010001
11111111 1111111 111111111111