EA Resources/texture/ea.xpm
WE Resources/texture/we.xpm
NO Resources/texture/no.xpm
SO Resources/texture/so.xpm
C 52,152,219
F 88,64,64



11111111111111111
10000000000000001
10000000000000001
10000000000111001
10000000011000001
1000W000000110011
10011101111111001
10000000000000001
10000000000000001
11111111111111111