EA Resources/texture/ea.xpm
WE Resources/texture/we.xpm
NO Resources/texture/no.xpm
SO Resources/texture/so.xpm
C 52,152,219
F 88,64,64




1111111111111111111
1000000000000000001
1000000100000000001
1000000011100000001
1000000000100000001
100000W000010000001
1000000000000000001
1000000000110000001
1000000000100000001
1111111111111111111

